%%%%%%%
% P   %
% %%% %
% %. G%
% %%% %
%     %
%%%%%%%
